5 35
4 2 6 P 2 10 T 12 22 T 3 0 T
1 13 13
2 5
EEEEEEEEEEEEEEEEEEEEEEEEEEEEEEEEEEEEEEEE
EEEEEEEEEEEEEEEEEEEEEEEEEEEEEEEEEEEEEEEE
EEEEEEEEEEEEEEEEEEEEEEEEEEEEEEEEEEEEEEEE
EEEEEEEEEEEEEEEEEEEEEEEEEEEEEEEEEEEEEEEE
EEEEEEEEEEEEEEEEEEEEEEEEEEEEEEEEEEEEEEEE
EEEEEEEEEEEEEEEEEEEEEEEEEEEEEEEEEEEEEEEE
EEEEEEEEEEEEEEEEERRRRRREEEEEEEEEEEEEEEEE
EEEEEHPPPPPPPPPPPEEEEEEEEEEEEEEEEEEEEEEE
EEEEEHEEEEEEEEEEEEEEEEPPPPPPEEEEEEEEEEEE
EEEEEHEEEEEEEEEEEEEEEEEEEEEEEEEEEEEEEEEE
EEEEEHEEEEEEEEEEEEEEEEEEEEEEEEEEEEEEEEEE
EEEEEHEEEEEEEEEEEEEEEEEEEEEEEEEEEEEEEEEE
EEEEEHEEEEEEEEEEEEEEEEEEEEEEEEEEEEEEEEEE
EEEEHEEEEEEEEEEEEEEEEEEEEEEEEEEEEEEEEEEE
EEEEHEEEEEEERRRRRRRRRRREEEEEEEEEEEEEEEEE
EEEEHPPPPPPPPEEEEEEEEEEPPPPPPPPPPPPPPPHE
EEEEEEEEEEEEEEEEEEEEEEEEEEEEEEEEEEEEEEHE
PEEEEEEEEEEEEEEEEEEEEEEEEEEEEEEEEEEEEEHE
PPPPPPPPPPPPPPPPPPPPPPPPPPPPPPPPPPPPPPPP
MMMMMMMMMMMMMMMMMMMMMMMMMMMMMMMMMMMMMMMM