5 35
3 2 6 K 2 10 T 4 18 T
1 15 15
2 4
HEEEEEEEEEEEEEEEEEEEEEEEEEEEEEEEEEEEEEEE
HEEEEEEEEEEEEEEEEEEEEEEEEEEEEEEEEEEEEEEE
HEEEEEEEEEEEEEEEEEEEEEEEEEEEEEEEEEEEEEEE
HEEEEEEEEEEEEEEEEEEEEEEEEEEPREEEEEEEEEEE
HEEEEEEERRRREEEEEEEEEEERRRRHHEEEEEEEEEEE
EHPPPPPPPEEPPPPPPHPPPPPPEEEHEEEEEEEEEEEE
EHEEEEEEEEEEEEEEEHEEEEEEEEEHEEEEEEEEEEEE
EHEEEEEEEEEEEEEEEHEEEEEEEEEHEEEEEEEEEEEE
EHEEEEEEEEEEEEEEEHEEEEEEEEEHEEEEEEEEEEEE
EHEEEEEEEEEEEEEEEHEEEEEEEEEHEEEEEEEEEEEE
EPPPPPPPHEEEEEEEEHEEEEEEEEEHEEEEEEEEEEEE
EEEEEEEEHEEEEEEEEHEEEEEEEEEHEEEEEEEEEEEE
EEEEEEEEHEEEEEEEEHEEEEEEEEEHEEEEEEEEEEEE
EEEEEEEEHEEEEEEEEHEEEEEEEEEHEEEEEEEEEEEE
EEEEEEEEHEEEEEEEEHEEEEEEEEEHEEEEEEEEEEEE
HPPPPPPPEEEEEEEEEHEEEEEERRRHPPPPPPPPHEEE
HEEEEEEEEEEEEEEEEHPEEEEEEEEEEEEEEEEEHEEE
HEEEEEEEEEEEEEEDEEEEEEEEEEEEEEEEEEEEHEEP
PPPPPPPPPPPPPPPPPPPPPPPPPPPPPPPPPPPPPPPP
MMMMMMMMMMMMMMMMMMMMMMMMMMMMMMMMMMMMMMMM
