17 12
5 9 17 K 2 27 T 12 4 T 12 35 P 12 24 K
1 17 12
2 6
EEEEEEEEEEEEEEEEEEEEEEEEEEEEEEEEEEEEEEEE
EEEEEEEEEEEEEEEEEEEEEEEEEEEEEEEEEEEEEEEE
EEEEEEEEEEEEEEEEEEEEEEEEEEEEEEEEEEEEEEEE
PPPPPPHPPPPPPPPPPPPPPPEEEEEEEEEEEEEEEEEE
EEEEEEHRRRRRRRRRRRRRRRRRREEEEEEEEEEEEEEE
EEEEEEHEEEEEEEEEEEEPPHEEEPPPPPPPPPPPPHPP
EEEEEEHEEEEEEEEEEEEPPHEEEEEEEEEEEEEEEHEE
EEEEEEHEEEEEEEEEEEEPPHEEEEEEEEEEEEEEEHEE
PHPPPPPEEEEEEEEEEEEPPPPPPPPHPPPPPPPPPPPP
EHEEEEPEEEEEEEEEEEEEEEEEEEEHEEEEEEEEEEEE
EHEEEEDEEEEEEEEEEEEEEEEEEEEHEEEEEEEEEEEE
PPPPPPPPPHPPPPPPPPPPPPPPPPPHEEEEEEEEEEEE
EEEEEEEEEHEEEEEEEEEEEEEEEEEHEEEEEEEEEEEE
EEEEEEEEEHEEEEEEEEEEEEEEEEEHEEEEEEEEEEEE
EEEEEEEEEHERRRRRRRRRRRRRRRRHEEEEEEEEEEEE
EEEHPPPPPPPPEEEEEEEEEEEEEEEPPPPPPPPPPPPH
EEEHEEEEEEEEEEEEEEEEEEEEEEMMMMMEEEEEEEEH
EEEHEEEEEEEEEEEEEEEEEEEEEEPEEEDEEEEEEEEH
PPPHPPPPPPPPPPPPPPPPPPPPPPPPPPPPPPPPPPPP
MMMMMMMMMMMMMMMMMMMMMMMMMMMMMMMMMMMMMMMM 