19 10
6 2 10 K 11 15 K 19 39 T 9 39 T 17 5 K 13 39 P
2 19 33 19 5
2 0
EEEEEEEEEEEEEEEEEEEEEEEEEEEEEEEEEEDEEEEE
EEEEEPPPPPPPPPPPHEEEEEEEEEEEEHPPPPPPPPPP
EEEEEEEEEEEEEEEEHEEEEEEEEHRRRHEEEEEEEEEE
EEEEEPEEEEEEEEEEHEEEEEEEEHEEPPEEEEEEEEEE
EERRRRRRRRRRRRRRHEEEEEEEEHDEEEEEHEEEEEEE
EHEEEEEEEEEEEEEEEEEEEEEEEEHPPPPPHEEEEEEE
EHEEEEEEEEEEEEEEEEEEEEEEEEHRRRRRHEEEEEEE
EHHEEEEEEEEEEEEEEEEEEEEEEEHREEEEPPPPPPPP
EEHEEEEEEEEEEEEEEEEEEEEEEEHEREEEEEEEEEEE
EHHEEEEEEEEEEEEPEEEEEEEEEEHEEREEEEEEEEEE
EHEEEEEEEEEEEEEEPPPPPPPPPPHEEERRRREEEEEE
EHHEEEEEEEEEEEEEEEEEEEEEEEHEEEEEEPPPPPPP
EEHEEEEEEEEEEEEEEEEEEEEEEEHEEEEEEEEEEEEE
EHHEEEEEEEEEEEEEEEEEEEEEEEHEEEEEEEEEEEEE
EHEEEEEERRRRRRRRRREEEEEEEEHEEEEEEEEEEEEE
PPPPPPPPEEEEEEEEEEPPPPPPPPPPPPPPPPPPPPHP
EEEEEEEEEEEEEEEEEEEEEEEEEEEEEPEEEEEEEEHE
EEEEEEEEEEEEEEEEEEEEEEEEEEEEEDEEEEEEEEHE
PPPPPPPPPPPPPPPPPPPPPPPPPPPPPPPPPPPPPPPP
MMMMMMMMMMMMMMMMMMMMMMMMMMMMMMMMMMMMMMMM
